##.....##.#.#####.#...###...#.##..#....##..#.##.#.#....##.....#.##.##.#.#.#...#.#.#.###.##..#.#.#.#..#.##.#...#..#.#.#..#####.##.#..#..##.#..#.#...#.....#.###..#..#####.##...#..##..##...#.#...##.##..##...##.##.#......#...##.##.#####.#....####....######.#.#.......#.############.###..#..#......####......#..##.####.##....#..#.#.###..#.####.####.#.##.##.##..###.#..#.......#....#..########....##..##.#...#.#.###.###.###..#..#.###..#....#.###..#.##.##..###.#.#####....###.##.###.....#######........#.#.##...##.#....

..##.#.#..#..##.###....######.####.....#.#..##..####......####...##...#.##..##.##.#.####.##.#.##.#.#
#.#####.#.#..#.#...##.......#.#...##.#..#.######....#.#####....####...##..##..#.#####..#.##......##.
....#..#...#...######...#.#.##.##.####..####....####.##.......#..##.#.##..#.#..##..#.##...##...#.#..
.#..#####..#..#..#.#.....#..###.###.##.#..#....#..#...#....#####...###.....#.##.####.#######.##..##.
###.###...###..##.##.######..####.#.###..#....####....#...#.##.#.#....#..#....#.#.#.#.#.......#..###
.#.##.#.#####.....#...##.##..##.##...#####....#.##.###.....##.#..#.######.....###...#.###....#...#.#
##..##.##...#######..#..#.###.##.#.###..##.#.#.#..#..#....##.#..###....#..##.#..#.#....##.##........
#..#......#.###.#####.##..#....#...#.#.#.#.###.##.##..#.#.##.#...#.##..##....#######.######..##.#.#.
.###.....#....###..#.#...##...#.#.####.##.###.#.##..##..###.#.##.####..##.....##....##.......#.#.###
..#.....#####.#.#..##..##..#.###..#.##.#..#.####....##..####.###....##.##.#.#...#..###.##......#####
#..#..####.#.#...#..#...#######.#......#.#.#..#.##.#......#......#.##.####.######....#####..##...###
.###.#...#..####.##...#.#####.##.#...#.#...#...#.#.##.###..#.##.###..#.##...######.#.#.##..#.##..###
####.#.##....#.#..#########.###.#.###.#..#.####.#..##.##..#.#.#....###...#..#..###..##...#..#.....#.
....#####.#..##.....###..#..#.##...#####..##...#...#.##.###....#..####.##.#####.##.#..##..##.#..#.#.
####...#..#####.#..#######.##.#.####...#####.#.#.##....#.###...#.###.##...#...##.##.##.#.#.....##.##
##..##.##.#.#..##..##.#..#.#..#.##.###.#..#..##.#..##..##.##.#......#.##..##.##.##.....##..#.#...###
#..#.#.#.#####..#.##..##....#.##.#.###.#.#...##.###.#..##.##...##..###.##...##.####...##.#..##..##..
####....##.#.#........###..#..####.###..#.#.#....#####.#.#...#.##.####.#..#...#..#.#...#.#...#.##.##
#..#..##.##..#....#...#.#.....#...#...##.....####.#.###.#.#.####.#..#.#.#...#.##.###...##.#.##..##.#
##..##..#.###.####.#####.###..#..#.....####.#..#.##.#####.##.#...##...###.######.#.#...#####.#..#...
#...##.#......#####..##..#.....#..###.#.....##.....#####....#.##.###...##.####.#.#...#.##.######.#..
##.#.###.##.......#.##.####..######...######...####.#..######....##.#.......####...###..##.##...#...
#.....##.#####.####..#.##.#.#.....##.#..#....#.....#.....#.#...#.###.#.....#####.#.###..##..##..###.
#.###..######..#....#...#.#.##..#.....#.###.....#..#.##..#..#.##....#.#..#..#..####.#.##.....#.#.###
#..##..#...##..##........#...#....###.###.#.########.#..#.............#....####..#..##.#.##.#......#
.###..#####........##..##.###.##..#.#.#.####.#..##.##.#...#..####..####..##.##..#.#.#.#......#.##.#.
#.##..##..######....#....##.....#...##..#.#.......#.##.#####.###..##...##.##.#..##.###...##########.
.##.########.##..###....#####.###.###.#.#.##.#.#.#..##.#.#..#.##..#....#.####..###.##..###.....##.#.
..##...#.###.#.#.#...#.##..#.#...#..##..##.##..#.#..##..#.##..##.###.##..##...#.###..##...#..#.#..##
.#.#.####.###.#.##.##.#.###.#.#....##.#........#..##..##..#...##..#.#.###.#.###..#...#.#.##.##..##.#
#.#.####.#.##...###.###.#...#.###.#.#.....#..#.##.#...#.#..#.#.##...###..###.#..#.###.#.####.###.#..
##..####...#.#.####..#..#...###.##.###.##...##.#.#..##..#.###.#.##.##.#..#.###.#..#######.#....#.#..
.#.#.######..##.#..###.##.#....##....#.#..###.....#.##...#..#...#.#.#.#.##....##....####....#......#
.#.#.#.##.###...##.#...###.#....#.#.#....##...#.######.#.#.#####..#..######.#.##.#.##.....##.####.##
..######...##..##..#.#.#.##.......##.#.#...#.#####...######..#######...####..##...#.##.##.#..#...#.#
##..#.#.#..##....#.##....#.....#.#####..#.#.#.#.#.#####....#..###..###.###...#...######...##..#.#..#
####.....##...##....##.##.#...#..##.#..###.#....#...###...#..######...####.###..##......##..###.##..
##.####...#.#.#.#..#..#.#.###..##.#....##.##..#..##........##.##.####.##.#.###.#.#....#####.#.....#.
#...#.....###..#..###..##..#.#..#.###.#..#####.#.###..###..#...##.#..##..#...##...#.#.###.#.#.##.###
##.#...#....##.########..##....##..###.#....###.#.#....#...###.....###.#.##.#..#####......###.#.#.#.
###.###.#...###..#.##....#.#.#.........#.#####.#.#...#######.###.#.#.#..#.#...#..##.#...###.#...##..
.####.###.#..#.###.#.#.######..#####.#...###..#...###..#.########.#.#.#..####..##.###..#..##..##....
#..##.#.#...####.#..#..#..###.##...#####..#.###......#..####.####.##..###.....###..#....#.#######...
###..##.#.#.#..##..##...#..#.#......#..####....#.##..#.##.###...####..##..####...#...###...##..#.#.#
##.##..#....###.##......#.#.##.#.###..##...##.##.#....#.#.#.###....##..#....#.########...#.....##.#.
#.#..###.....#######..#.###....####...##......####..#...##....#..####.#....##.#...#....##.###.##....
#....######..##.##..##.###.....##..#.....#....##...#....###.....##.##...##.#..##.####.#..####.##.#.#
.#.#....#..####..#..#.#...#..#..###..#........###.##...##.##....#.#..#.##..#.##...#####...#..#####..
.##..####..##...##.###.#..####...#....#..#..##.#...##...#.###.....#.#..######.#.#####..#####..######
.#...#.#..##.#.##..#.#.#...###..#..#....###.########..######.#.####...##..#..#...##.####...#.#######
.#####.##.#####.#.#.##.#.#....#..###.#..##......#####..#.##.#########...##..###.######.....#.#.####.
##.#.#.#.##..##.##...#.....#########.##.#.......#..#####.#..#.#.#######...#..##.#..###.#####...##.##
##.##...###.###...#..##.#..#.##.##.....##.#.#.###...##.#.##..#.#.#...####..#..###.####..#...##.##.#.
#...#.#.#..#.##..#..####.#..###.#####...#..#.#..#####.#..#.......#..#.....#.#.#.#.#.##.##.###....#.#
....##..#..####.##..#.#...#####...#...###.##.#.#...##.##.##..######......####.##.#..#.##..##...####.
##...###..#.##..##..#.##...#.#.####.####..#.#.###..#.#..##.#...#.#.####..#.#.##.##.#.###.#.###.#.#..
#.#.#.#..#######.#....#..#.#.####....##...##.###.####.####.#..#..##...##..#..##....#...#..##.####...
.#####.###.##.##..##.##.##.#.##...##..#..##...#.#.##.#...####..#####..#.............###..#..#..#.#..
.##..##..###.##.##.....#...#....#..#..#.#######....#...#......##.###..#....#.#.####.#....###..##..#.
.##.#.###......#.###..#.#..#.##.###.#.#..#.#.##......##.#..##.###..#.###.##...##.#.........###.#.###
.#.#.###......#..#####.###..#..#.##..........#..##.###.#.##.#..#.##.#.###.#.###..#.#...#.###..###...
.###.####.##.##.###..#.#..###..##..##....###.###..#...###...#.##.#...#.#.##..###.##.##..###.##....##
###.########.#.######..#.##.#.#####.###...###.###.#####.###..#...#.###..#...#..#.###.#......#......#
.##....###...##.####....#....#..##...#....###..#..#..#...#...#..##....#####.#..###...##.####....###.
.....#..##...##....####.#..#.#.##..####.#####..###...###.###..##..#...##.....#.#.##...#.....#.####..
.#.###.#.#..#.####....#.#.##..#.####..#...#.#.#.#..#..#.####.###....#####.#..##..#.#..##.#.####.#.#.
#.####.#.....###..###.#..#.####.#..#.#.##.##..##..#.#.#..##...#.####..#.###...#....#.#...#.#..##.#..
.#.####...#.#.#..###.##..#.#...##.##.#.....######...#....#.#.##.....###......##.#...#.###..#....###.
..##.###......#.##...###.#...######..##.#.#.#.#..#####.##...#......#....#.####..#..#..#.#.#.#..#..##
#.##.##.#.##.#.#..#.#.#..###....#####..#.#####.####.##.##.#.##.#..#.#.#.#.###..##.##.#####..##.#####
..#.#..##.#.##.#..###..##.#.#..#.#..#.##....#....##..#.#..#.#.##.##.#.#.#..##..###..##.##.#.###.####
####.####..#..#.#....##.#...##....#.######...#.##.....#.##..#####.#####..##..#.####.#.##......#.#...
.#####..##...#....#.#..#.#.##.#...#.#..#..###.#..#.#..#..##.#.....#.####.#.#...###..#..##.##......##
###.#.....###...###########.##.##..#....##.#.####.#.#.#.....#...###.#.##..#.#.#...###..........###.#
#.#.##.##..#..#.##.#..##.#.#.####..###.#.#..###.#.#.###..###..#.##...#..#..#.#...#...#..##..#..###..
..#.#####.###..#.......#..#.####.#.######....#.##.##.#..#..#####..#...#.##.##.##..#...#####.##..#..#
##..##...##...#.####...#.#....##..#.....##.###.####.##..###..#.##..#..##..####....##.#...#.####.#..#
#.#.##...####..#.##....##...#.###..##....##.#.#.....###...####..###.###..#...##.###.#.#.#.#....#.##.
..####.##..##.#.....##...#.#.##.#.....#.#.##..##.##..#.##...##....#.#...###..####.#.#######..##.#.##
#.....##...#...#...#.##.#.####.###..#.#..###.#.#..#######...#.##.###.#.###.#.##.#.##.....#.#...#.##.
#..#####.....#..#..###.#####..##.##....#.###.##.#.#..##...###...#######.##....#...###...#####..##..#
#..############.##.####..#..#..#..#.####........#.###.###..#.######...##..####..###......##.#.#..#..
##.............###.#.####....##.##....#.#.....#.#.###...##.##.#.#..###.##.##..#.#.#####..#.#.#....##
.####...###.#.###.#..#.#.#.####.#......#..#..#.#...#..#..#....#.##..##.#..##.#..#....#..##.#..##.#.#
###.#..#..###.#...#....###..########....##....#....#.###.#.##...###.#.#.#..##..#.##....#.######.#.#.
#.###....#.##.#.#...#.##.###.##..#..###.##...####..#..#..#.####.#..#..#..#.###....#..#.##...##...###
#..#.##.#.#.#...#.#####.##.#..###.#.#.###........####.#####..#.##..###....#..#.#.#...#.#.#..#.#####.
#..##.##.#####...##...##.##..##.#...#.#..#...#..#..#.....#..####.#...#..#######....########.....#.##
#.....####.#.#.#..#.##..#.#.#####..#.#..######.#.#..#...#..#....#.##.##..##.#.###..#.##...##.#...##.
.###.#..##.##....#.##.#..#.##..####.......##..##.##.#####.###.##.....#.....##.###.#.##.#.#.##..#..##
##....#.#.##.###.#.##.#####.#..#####.#..#####.##.#..#..#..#####.##.###.#..###...#.#...#....######..#
####..#..#..#..######...#####..#..#.#...#.##....###...#...##......#...#####.##.#..#.#.##.#...##.##.#
####...##...#..#..##..#.#....#####...#.#....######.#.#.....#...##..##.##..##...##.###.....##....##.#
.#.####.#..##..####...#.##.##.##..#####..##.#.#..##....#..#.#.####..##.##.#.###.##..####......##.#..
...#..####...##.##.#..#.#....#######.####.#...###....##.#...####.#.###.####.#.#.##.#.......###.####.
.......#..#..#.#..#..#...#.#####.#.#..####..#..#...##..#.#.####.#...#.#.#.#.#.#...#.#.##.#..#.#.####
...###.#...#..#.#.#.....##.##.#.#..##.#......#.#######.....#..###.#####.##..###.#..#.#######.#####.#
.####.#..#.#.###...#..#####...#....##..####..#..#######.###.##.##..######.###..##...#####...#.##.#.#
#..##..####.#.#.#..#.####.###...#..###.#.##.##..####..###.####.....#..#.#.####...#.#.#.##.##..#.#.##
..#.###.#...###..#...###.###.####..##..#.#...##.#...#..#....#####.#####..##.####..##.##.##..#...####
